#############################
# @                        N#
#                          N#
#                          N#
#                          ##
#                           #
#                           #
#                           #
#                           #
#                           #
#                           #
#                           #
#                           #
#                           #
#                           #
#OOO#                      .#
#############################