######
#@   #
#OO  #
#.   #
######