###########
#@        #
#         #
#   ===   #
#   ===   #
#   ===   #
#         #
#         #
###########