##################
#@#      #L W    L#
# #      # R  O R #
# #      #        #
# #      #        #
# #      # R W  R #
# #      #L    O L#
# #################
# #      OOO#
# #OOO      #
# #WWW      #######
# #         N#####
# #         S#NOW#
# #          # ###
# #         S#
#.#         S#
##############