###########
#@        #
#OOO      #
#      WWW#
######### #
#.        #
###########