#########
#@     .#
#########
#  OS   #
#  NW   #
#       #
#OOO    #
#########