###########
#         #
#   @     #
#O   L    #
#         #
#.        #
###########